ah = [uh,la,larh,arh,lah,eh,luh,ley,lei,lorh]
ar = [lar,noted,lh,keng,npk,ching,terr,kannina,mabel,chee]
arh = [ley,lei,larh,ahh,simi,cfm,cher,bo,jiu,luh]
ba = [lo,ti,bei,ge,bah,wo,orh,chee,bu,dou]
bah = [lo,ba,sob,#snacks,agn,dao,goodnights,tweetmr,lorh,orh]
de = [shi,deo,v,jiang,un,ba,bon,wo,zhen,huan]
der = [plak,aq,td,nonton,kalo,gak,sok,cocok,bgt,sih]
eh = [ehh,oi,alamak,ah,uh,ley,eee,lanjiao,haisss,kimak]
ei = [raikkonen,wapi,goodwill,#tyranny,senator,zil,ser,#football,presenter,#ss5mexico]
ey = [yess,bgr,woy,iya,ven,iyaa,sihh,tante,alay,makasih]
geh = [kiang,jiao,hao,xia,zuo,bai,mai,bu,gao,jiu]
gey = [gils,ninabui,gam,nao,honggan,zat,ayu,jiak,qin,zhong]
ha = [gustado,wjmk,difft,innallah,37.74,drumroll,#ttalive,ryu,fringes,2ma]
hah = [yeah,hahahah,hahah,nope,anyway,yup,sigh,hahaha,nah,kidding]
har = [gow,gows,bohcui,yuuki,siewmai,15000,irrinoying,wel,martabak,#iinsist]
harh = [dwnload,zhendong,nae,idt,arimasen,headband,afk,alain,haniza,ernii]
hoh = [derrick,cwe,selesai,cowok,genki,pgn,kode,elu,gaara,opo]
hor = [leh,horh,lorh,lei,lor,cfm,bo,aiya,nia,jiu]
horh = [lorh,hor,lai,geh,cher,orh,okok,steady,bo,lei]
huh = [yea,isit,lol,aha,gangs,thats,lmao,hah,uh,lolol]
kan = [pun,gitu,dia,tau,orang,tahu,je,kalau,sudah,hati]
la = [lah,luh,larh,uh,ah,lor,laa,lorh,arh,laaa]
lah = [la,larh,uh,laa,ah,luh,laaa,lahh,ahh,kk]
lar = [shen,terr,po,boh,ee,xia,heee,tuhh,tupid,#dc]
larh = [ley,luh,lei,la,buey,geh,ahh,dao,lorh,diao]
le = [ma,mah,liao,mum's,yay,mummy,bai,nian,sissy's,alrd]
leh = [lor,lei,hor,ley,meh,jiu,sia,lorh,liao,walao]
lei = [ley,larh,geh,leh,bo,hor,jiao,zhen,guai,jiu]
ler = [tau,kite,lh,bnyk,siot,nnti,beh,blaja,blh,tidak]
lerh = [minom,viennese,ary,#wine,mansor,betis,elyana,sedihh,uff,ngidam]
ley = [lei,larh,geh,ahh,lorh,leh,sibei,buey,zzzz,arh]
liao = [alr,cfm,alrd,alrdy,den,jiu,somemore,hor,nia,also]
liau = [wtheck,salsha,nodding,urbang,owwww,luuu,ohcem,utara,kiiroitori,batchmates]
liaw = [#or,#classmates,#act,subh,#haha,#nope,teuing,bol,mangga,jesse]
liow = [qing,zhe,fen,fei,zhi,kuai,shmo,nocturne,tor,kuey]
lo = [loh,ba,orh,bah,ka,ge,dong,;p,shi,laiiiii]
loh = [ga,bgt,si,udh,gak,gue,iya,aja,di,dong]
lor = [lorh,leh,hor,la,lo,luh,lei,larh,ley,meh]
lorh = [lor,jiu,horh,ley,hor,luh,larh,geh,lei,aiya]
ma = [mah,yo,le,my,ur,det,his,laurel,puffy,tf]
mah = [ma,yo,le,lo,laurel,na,#cners,puffy,yur,nim]
marh = [3plus,ofidhlsendc,pubor,muahahahahahaha,taht,wonderwoman,ngiam,pevita,diffusion,terbgun]
meh = [leh,also,ley,sia,lor,lei,aiya,uh,cfm,hor]
mey = [sara,repath,restoran,hhe,#thursday,rin,icawls,capek,femyds,beneran]
na = [sa,talaga,ng,ho,han,ge,nakita,loh,di,dong]
nah = [nope,tho,maybe,yeah,alright,sorry,either,cuz,anyway,okay]
nar = [#la,seized,headquarters,covadonga,#instagram,rig,#outing,slowdown,#travel,#instaphoto]
nia = [somemore,ltr,kns,kpkb,nid,hor,sua,cher,liao,ownself]
niah = [saja,berjela,jangkit,menyebok,tngh,terkejut,mestila,ubat,sesuai,ganas]
sak = [gile,gila,asl,betul,muke,muka,korang,macam,mcm,sumpah]
seh = [sey,siol,sak,pe,gile,gila,sei,siak,alah,chey]
sei = [gile,sak,sngt,siaa,boncit,muke,ler,giler,haisss,seh]
sey = [gile,seh,sgt,lagi,gemok,kite,chey,fuh,lek,rindu]
sia = [sial,cb,seh,siaa,meh,ley,siah,leh,knn,siak]
siak = [sak,babi,gile,betul,pukimak,gila,gini,sumpah,sey,cemue]
sial = [siak,sia,siol,cb,buto,bodoh,kimak,babi,siaa,sak]
siol = [seh,sey,kirekan,siak,sial,albino,sak,lek,fuh,alamak]
siot = [pulak,dari,blh,paling,selalu,ngn,skrg,satu,sume,bilik]
uh = [ah,la,luh,lorh,ley,lah,hahahah,larh,hahah,isit]
wat = [wht,wad,hw,nth,ntg,lyk,whr,aoi,dis,lik]
what = [whatever,that,something,anything,everything,how,which,where,it,nothing]
woh = [watchong,blum,oui,woiii,loco,cabe,smpe,atut,ciyee,bohong]
wor = [#oppopulation,deo,#todosobretec,#urbanwakeupcall,#kavenyou,bruce,#nofilter,wha,un,douglascastle]
worh = [tor,zhui,cette,somenore,#ar,fais,liaos,#femmex,flor,sesuai]
